R   6000 4000
NO  text_sprites/north.xpm
SO           text_sprites/south.xpm
WE      text_sprites/west.xpm
EA                    text_sprites/east.xpm
S               text_sprites/chapa.xpm

C 80,80,80

F  50,50,50


11111111111111111111111111
10000000000000000000000001
10000000000200000000000001
111100000000E0000000000001
10000002000000000000000001
11111100000000000000000001
10000000000000000000000001
10000000000020000000000001
10000000000000000000000001
10000000200000000000011111
10000000000011100000000001
11111111111111111111111111
