R 8000 4000

NO ./text_srites/NO.xpm
SO ./text_sprites/SO.xpm
WE ./text_sprites/WE.xpm
EA ./text_sprites/EA.xpm

F 80, 80, 80
C 50, 50, 50

1
11
101
1001
10001
10001
1E001
100001
1000011111 
100000001
1000200011 
111111111 
