R 1000 1000
NO ./textures/NO.xpm
SO ./textures/SO.xpm
WE ./textures/WE.xpm
EA ./textures/EA.xpm
S ./textures/migu/cat.xpm
F 182,182,182
C 182,182,1

11111111111111111111111111111
11100010010001111011010101011
10001020100010001001100010001
10000000000000000000000000001
10000111100001111000011110001
10000111000000110000001100001
10000010000000010000000100001
1000002000000000000000S000001
11100000000000000000000000111
11110000000000200000000001111
11111000000000000000000011111
11111100000000000020000111111
11111111111100001111111111111
11111100000000000000000011111
11110000200000000020000000001
11111100000000011111100000001
11111111111111111111111111111
