R      6000 4000

       NO  text_sprites/north.xpm

  SO                text_sprites/south.xpm

         WE      text_sprites/west.xpm

    EA                    text_sprites/east.xpm

       S               text_sprites/migu/cat.xpm



C        80,     80,      80

F  50,     50,           50







    1111111111111111111
    1000000 00000000001
   11100000000200000111
111100000000E00  0000011
  11000002000  000000011111
1111110000000111111111111
   10000000000000000000001111
11110011000020001111111111
111111110000000011111
1111111100000000000011111
      11000000111000001
      11111111111111111
