R      6000 4000

       NO  text_sprites/ENWL19B.xpm

  SO                text_sprites/BOARDS1.xpm

         WE      text_sprites/BLUTX4T.xpm

    EA                    text_sprites/ENWL19F.xpm

       S               text_sprites/cat.xpm



C        80,     80,      80

F  50,     50,           50







    111111111111111111
    100000000000000001
   11100000000200000111
111100000000E000000011
  11000002000000000011111
1111110000000111111111111
   10000000000000000000001111
11110011000020001111111111
111111110000000011111
1111111100000000000011111
      11000000111000001
      11111111111111111
