R 	200000 1000000			
	NO	 	        	./textures/north.xpm 		 
 	SO	  	    	./textures/south.xpm		  		
	 WE	    	textures/west.xpm		
EA 		textures/east.xpm 		
S  textures/cat.xpm

C 200,	255, 200

F 80,150,80


       11111111111111111111111
       12000000000200000000021
       10000000000E00001111111
       11111112000000000111111000021
111111110000000000000001
10000000000020000000001
10000000200000000000001
12000000000020000000021
11111111111111111111111


1111
1001
1 01
1001
1111
