R   6000 4000
NO  text_sprites/north.xpm
SO           text_sprites/south.xpm
WE      text_sprites/west.xpm
EA                    text_sprites/east.xpm
S               text_sprites/migu/cat.xpm

C 80,80,80

F  50,50,50


11111111111111111111111111
10000000000000000000000001
10000000000200000000000001
11110000000000000000000001
10000002000000000000000001
1000000000000  00000000001
1000000100002  00000001111
100000111 0000000000000001
10000001200000000000S00001
10000000000011100000000001
11111111111111111111111111
