R   5500  7800
NO   ./textures/north.xpm
SO           ./textures/south.xpm
WE      ./textures/west.xpm
EA                    ./textures/east.xpm
S               ./textures/migu/cat.xpm

C 200,200,200

F  80,80,80


11111111111111111
10000000000000001
10000000000000001
10000000000000001
10000000000000001
10000000100000001
10000000000000001
10000000E20000001
10000000000000001
10101010101010101
11111111111111111
