R 	1920 		1080 	
	NO	 	        	./textures/north.xpm 		 
 	SO	  	    	./textures/south.xpm		  		
	 WE	    	textures/bluestone.xpm		
EA 		textures/east.xpm 		
S  textures/pillar.xpm

C 50,	50, 20

F 80,150,80


          11111111111111111111111111
          10000000000000000000000001
          10000000000200011111111111
11111111111000000000000001
10000002000000000000000001
10000000000000000000000001
10000001000020000000001111
10000011100000000000000001
10000001200000000000N00001
10000000000011100000000001
11111111111111111111111111


1111
1001
1 01
1001
1111
