		R 6000 4000 
 
 NO textures/north.xpm

  SO           textures/south.xpm

         WE      textures/west.xpm

    EA                    textures/east.xpm

       S               textures/migu/cat.xpm



C        80,	80, 100

F  50,	     50,           50







   11111111111111111111
   10000000000000000101
   100000000200000001
111100000000E0000000111111
  110000020000000000 011111
1111000000000000000000111
   10000000000000000001111
11111111000020000000001111111111
111111110000000000000011111
111111110000000000000011111
      11000000101000001
      11111111111111111
