R      6000 4000

       NO  ./textures/NO.xpm

  SO                ./textures/SO.xpm

         WE      ./textures/WE.xpm

    EA                    ./textures/EA.xpm

       S               ./textures/migu/cat.xpm



C        80,     80,      80

F  50,     50,           50







    1111111111111111111
    1000000000010000001
   11100000000010000111
111100000000000100000011
  110000000000000000011111
1111110000000E0000001111111
   10000000000000000000001111
111100110000000000000001111
10000000000000000000011111
1111111000000001000011111
      11000000111000001
      11111111111111111
