 	R 	1920 		1080 	
	NO	 	        	./textures/north.xpm 		 
 	SO	  	    	./textures/south.xpm		  		
	 WE	    	textures/west.xpm		
EA 		textures/east.xpm 		
S  textures/migu/cat.xpm

C 80,	0, 80

F 50,50,100


          11111111111111111111111111
          10000000000000000000000001
          10000000000200001111111111
11111111112000000000000001
10000002000000000000000001
10000000000000000000000001
10000001000020000000001111
10000011100000000000000001
10000001020000000000N00001
10000000000011100000000001
11111111111111111101111111


1111
1001
1 01
1001
1111
