		R 64  32  		 	 		

 NO textures/north.xpm

SO           textures/south.xpm

         WE      textures/west.xpm

    EA                    textures/east.xpm

       S               textures/migu/cat.xpm



C        0,	80, 100

F  50,	     50,           50

111111111111111
    1111
11101101
    1001
    1S01
11111021
11111111
