R 	10 		7					
	NO	 	        	./textures/north.xpm 		 
 	SO	  	    	./textures/south.xpm		  		
	 WE	    	textures/bluestone.xpm		
EA 		textures/east.xpm 		
S  textures/ninja.xpm

C 50,	50, 20

F 80,150,80


       11111111111111111111111
       12000000000200000000021
       100000000000000W1111111
       11111112000000000111111000021
111111110000000000000001
10000000000020000000001
10000000200000000000001
12000000000020000000021
11111111111111111111111


1111
1001
1 01
1001
1111
