R       1920  1

   NO  ./textures/north.xpm  

  SO                ./textures/south.xp koajjjnm

         WE      ./textures/west.xpm

    EA                    ./textures/east.xpm

       S               ./textures/migu/cat.xpm



C        80,     80,      80

F  50,     50,           50







    1111111111111111111
  1010000000001000000001
  11100  00001000000001011
11110000000000010000011
  1100000000   000000011111
11111100000E  000001111111
   1000000000000000000001111
11110011000  00000000001111
100000    0000000000011111
 1111111000000001000011111
      11000000111000001
      11111111111111111
