R 	1920 		1080 	
	NO	 	        	./textures/north.xpm 		 
 	SO	  	    	./textures/south.xpm		  		
	 WE	    	textures/bluestone.xpm		
EA 		textures/east.xpm 		
S  textures/migu/cat.xpm

C 50,	50, 20

F 80,150,80


11111111111011111111111
12000000000000000000021
10000000000000N00200001
10200000000000000000001
10200000000000000000001
10000000000020000000001
10000000200000000000001
12000000000020000000021
11111111111111111111111


1111
1001
1 01
1001
1111
