R 642982 516464

NO ./textures/north.xpm
SO ./textures/south.xpm
WE ./textures/west.xpm
EA ./textures/east.xpm

S ./textures/migu/cat.xpm
F 100,100,100
C 80,80,80

11111111111111111111111111111
1020000000000W000000000002001
11111111111111111111111111111
