
R 1960 1280

NO ./textures/north:.xpm
SO ./textures/south.xpm
WE ./textures/west.xpm
EA ./textures/east.xpm

S ./textures/migu/cat.xpm
F 224,172,105
C 205,249,255

111111111111111111111111111111111111111111111111111111111
100000000000000000011111110000000000000000000000000000001
100010100000000001111110000000200000000000000000100000001
100010200000000000000000000000000000000000W00010000000001
100010100000000000111110000000000000000000000000100000001
100000000000000000001111000000000011111111111111100000001
101010100000000000000001111111111111000000000000100000001
101010100010100000000000000000000000011111100000000000001
101000000000000010100010001000111000000000000000000000001
100000002000000000000000000000000000000000000000000000001
100000000000000000000000000000011111011101100000000000001
101000000000000010100010001000111111111101111111100000001
101010100010101010101010001001111111111101111111100000001
111111111111111111111111111111111111111111111111111111111
