R	1080	  720	

NO ./textures/north.xpm
SO ./textures/south.xpm
WE ./textures/west.xpm
EA ./textures/east.xpm

S ./textures/migu/cat.xpm

F 224,172,105
C 205,249,255

11111111111111111111111111111
10000000001100000000000000001
10110000011100020000000010001
101200000000000000000W0010001
10110200011100000000000010001
10000000001100000000011110001
11110000000000002000000010001
11110000000000011101010000001
11000000110101011000000000001
10002000000000000000000000001
10000000000000000000000000001
11000000100000011111011110001
11110000000000011111011110001
11111111111111111111111111111
