S ./textures/pillar.xpm
 R 900 600


 NO ./textures/north.xpm
          	 SO	 ./textures/south.xpm      
WE 		./textures/west.xpm
EA 		./textures/east.xpm


       F	  220,100,1
  C 	225,30,1


1111111111111111111111111111111
1000000000000200000000000000001
1000101010000000200000000000001
1100011111000000000000000200001
100110001000000N000000000000001
1111000000000000000000000000001
111100001001002100000111111111100000001
1000000011000001000001000000001
1000000011000000000000002000001
1011111111110001111110000000001
1010101000000000000001111111111
1000001000001111111110000000001
1000000000000000000000000000111
1111111111111111111111111111111
