R  1080 720
NO ./textures/north.xpm
SO ./textures/south.xpm
WE ./textures/west.xpm
EA ./textures/east.xpm

S ./textures/ninja.xpm
F 224,172,105
C 205,249,255

111111111111111111111111111111111
100000000000000000000000000000001
100000002000000000000000000000001
100000000000000000000000000000001
100000000000000000002000000000001
100000000020000000000000000000001
100000000000000000000000000000001
100000000000000000000000000000001
100000000000000000000000000000001
100000000000000N00000000000000001
100000000000000000000000000000001
111111111111111111111111111111111
