R 530 600   
NO text_sprites/cobre.xpm
SO text_sprites/arenisca.xpm
WE text_sprites/chapa.xpm
EA text_sprites/piedra.xpm
S  text_sprites/bambu.xpm
F 80, 80, 80
C 50, 50, 50

111111111111111111111111111 
100000000000000000000000011
100000000000000000000000011
10000000000000000000000001101
100002222222220000000000111
100000000000000002000000011
10000000000000000000011111110001
1000000000000000000000W11111 
10000000000000200000001111111101
1000000000000000000000000111111
100000000000000000000001111111101
100000000000000000000000011111
10000000000000000000000101111
100000000000000000000000111111
10000000000000000000000001111
11111111111111111111111111111111
