R 800 600   
NO ./textures/north.xpm
SO ./textures/south.xpm
WE ./textures/west.xpm
EA ./textures/east.xpm
S  ./textures/migu/cat.xpm
F 80, 80, 80
C 50, 50, 50

111111111111111111111111111 
100000000000000000000000011
100000000000 00000000000011
1000000000000000  00000001101
100002222222220000000000111
100000000000000002000000011
10000000000000000000011111110001
1000000000000000000000011111 
10000000000000200000001111111101
1000000000000000000000000111111
100000000000000000000001111111101
10000010E000000000000000011111
10000000000000000000000101111
100000000000000000000000111111
10000000000000000000000001111
11111111111111111111111111111111
